xxxxxxxxxxxxxxxxxxxxxxxxxxxxxxxx
x  x   x              x        x
x  x   x     x        x        x
xg x   x     x        xxxxxx xxx
x      x     x        x        x
x           gx        x        x
x      x     x                 x
x      x              x        x
xxxxxxxxxxxxxxxxxxxxxxxxxxxxxxxx