xxxxxxxxxxxxxx
x  x   x     x
x  x   x     x
xg x   x     x
x      x     x
x           gx
x      x     x
xxxxxxxxxxxxxx